0***************
00*0*0000000000*
*0*000********0*
*0*0*0*000*00*0*
*0*0*0*0*0*0**0*
*0*0*0*0*0*00*0*
*0*0*0*0*0**0*0*
*000*0*0*0000*0*
**0****0******0*
*000*000*0000*0*
*0*0*0*0*0**0*0*
*0*0*0*000**0*0*
*0*0*0*0**000*0*
*0*0*0*0*00***0*
*0*000*0*0000000
**************00
